02 03 04 05 01 01 01 01 01 01 01 01 01 01 01 01 01 01 01 01 01 01 01 01 01
18 19 20 21 01 01 01 01 01 01 01 01 01 01 01 01 01 01 01 01 01 01 01 01 01
34 35 36 37 01 01 01 01 01 01 01 01 01 01 01 01 01 01 01 01 01 01 01 01 01
50 51 52 53 01 01 01 01 01 01 01 01 01 01 01 01 01 01 01 01 01 01 01 01 01
66 67 68 69 01 01 01 01 01 01 01 01 01 01 01 01 01 01 01 01 01 01 01 01 01
02 03 04 05 01 01 01 01 01 01 01 01 01 01 01 01 01 01 01 01 01 01 01 01 01
18 19 20 21 01 01 01 01 01 01 01 01 01 01 01 01 01 01 01 01 01 01 01 01 01
34 35 36 37 01 01 01 01 01 01 01 01 01 01 01 01 01 01 01 01 01 01 01 01 01
50 51 52 53 01 01 01 01 01 01 01 01 01 01 01 01 01 01 01 01 01 01 01 01 01
66 67 68 69 01 01 01 01 01 01 01 01 01 01 01 01 01 01 01 01 01 01 01 01 01
02 03 04 05 01 01 01 01 01 01 01 01 01 01 01 01 01 01 01 01 01 01 01 01 01
18 19 20 21 01 01 01 01 01 01 01 01 01 01 01 01 01 01 01 01 01 01 01 01 01
34 35 36 37 01 01 01 01 01 01 01 01 01 01 01 01 01 01 01 01 01 01 01 01 01
50 51 52 53 01 01 01 01 01 01 01 01 01 01 01 01 01 01 01 01 01 01 01 01 01
66 67 68 69 01 01 01 01 01 01 01 01 01 01 01 01 01 01 01 01 01 01 01 01 01
02 03 04 05 01 01 01 01 01 01 01 01 01 01 01 01 01 01 01 01 01 01 01 01 01
18 19 20 21 01 01 01 01 01 01 01 01 01 01 01 01 01 01 01 01 01 01 01 01 01
34 35 36 37 01 01 01 01 01 01 01 01 01 01 01 01 01 01 01 01 01 01 01 01 01
50 51 52 53 01 01 01 01 01 01 01 01 01 01 01 01 01 01 01 01 01 01 01 01 01

17 17 17 17 17 00 00 00 00 00 00 00 00 00 00 00 00 00 00 00 00 00 00 00 00
17 17 17 17 17 00 00 00 00 00 00 00 00 00 00 00 00 00 00 00 00 00 00 00 00
17 17 17 17 17 00 00 00 00 00 00 00 00 00 00 00 00 00 00 00 00 00 00 00 00
17 17 17 17 17 00 00 00 00 00 00 00 00 00 00 00 00 00 00 00 00 00 00 00 00
17 17 17 17 17 00 00 00 00 00 00 00 00 00 00 00 00 00 00 00 00 00 00 00 00
17 17 17 17 17 00 00 00 00 00 00 00 00 00 00 00 00 00 00 00 00 00 00 00 00
17 17 17 17 17 00 00 00 00 00 00 00 00 00 00 00 00 00 00 00 00 00 00 00 00
17 17 17 17 17 00 00 00 00 00 00 00 00 00 00 00 00 00 00 00 00 00 00 00 00
17 17 17 17 17 00 00 00 00 00 00 00 00 00 00 00 00 00 00 00 00 00 00 00 00
17 17 17 17 17 00 00 00 00 00 00 00 00 00 00 00 00 00 00 00 00 00 00 00 00
17 17 17 17 17 00 00 00 00 00 00 00 00 00 00 00 00 00 00 00 00 00 00 00 00
17 17 17 17 17 00 00 00 00 00 00 00 00 00 00 00 00 00 00 00 00 00 00 00 00
17 17 17 17 17 00 00 00 00 00 00 00 00 00 00 00 00 00 00 00 00 00 00 00 00
17 17 17 17 17 00 00 00 00 00 00 00 00 00 00 00 00 00 00 00 00 00 00 00 00
17 17 17 17 17 00 00 00 00 00 00 00 00 00 00 00 00 00 00 00 00 00 00 00 00
17 17 17 17 17 00 00 00 00 00 00 00 00 00 00 00 00 00 00 00 00 00 00 00 00
17 17 17 17 17 00 00 00 00 00 00 00 00 00 00 00 00 00 00 00 00 00 00 00 00 
17 17 17 17 17 00 00 00 00 00 00 00 00 00 00 00 00 00 00 00 00 00 00 00 00
17 17 17 17 17 00 00 00 00 00 00 00 00 00 00 00 00 00 00 00 00 00 00 00 00

02 03 04 05 00 00 00 00 00 00 00 00 00 00 00 00 00 00 00 00 00 00 00 00 00
18 19 20 21 00 00 00 00 00 00 00 00 00 00 00 00 00 00 00 00 00 00 00 00 00
34 35 36 37 00 00 00 00 00 00 00 00 00 00 00 00 00 00 00 00 00 00 00 00 00
50 51 52 53 00 00 00 00 00 00 00 00 00 00 00 00 00 00 00 00 00 00 00 00 00
66 67 68 69 00 00 00 00 00 00 00 00 00 00 00 00 00 00 00 00 00 00 00 00 00
02 03 04 05 00 00 00 00 00 00 00 00 00 00 00 00 00 00 00 00 00 00 00 00 00
18 19 20 21 00 00 00 00 00 00 00 00 00 00 00 00 00 00 00 00 00 00 00 00 00
34 35 36 37 00 00 00 00 00 00 00 00 00 00 00 00 00 00 00 00 00 00 00 00 00
50 51 52 53 00 00 00 00 00 00 00 00 00 00 00 00 00 00 00 00 00 00 00 00 00
66 67 68 69 00 00 00 00 00 00 00 00 00 00 00 00 00 00 00 00 00 00 00 00 00
02 03 04 05 00 00 00 00 00 00 00 00 00 00 00 00 00 00 00 00 00 00 00 00 00
18 19 20 21 00 00 00 00 00 00 00 00 00 00 00 00 00 00 00 00 00 00 00 00 00
34 35 36 37 00 00 00 00 00 00 00 00 00 00 00 00 00 00 00 00 00 00 00 00 00
50 51 52 53 00 00 00 00 00 00 00 00 00 00 00 00 00 00 00 00 00 00 00 00 00 
66 67 68 69 00 00 00 00 00 00 00 00 00 00 00 00 00 00 00 00 00 00 00 00 00
02 03 04 05 00 00 00 00 00 00 00 00 00 00 00 00 00 00 00 00 00 00 00 00 00
18 19 20 21 00 00 00 00 00 00 00 00 00 00 00 00 00 00 00 00 00 00 00 00 00
34 35 36 37 00 00 00 00 00 00 00 00 00 00 00 00 00 00 00 00 00 00 00 00 00
50 51 52 53 00 00 00 00 00 00 00 00 00 00 00 00 00 00 00 00 00 00 00 00 00

